acts	AE K T S
acts(2)	AE K S
amos	EY M AH S
colossians	K OW L AA S IY AH N Z
daniel	D AE N Y AH L
deuteronomy	D IY Y AH T AH R AA N AH M IY
ecclesiastes	EH K L IY S IY AH S T S
ephesians	AH F IY S IY AH N Z
esther	EH S T ER
exodus	EH K S AH D AH S
ezekiel	EH Z EH K IY AH L
ezra	EH Z R AH
first-chronicles	F ER S T K R AA N IH K AH L Z
first-chronicles(2)	F ER S K R AA N IH K AH L Z
first-corinthians	F ER S T K OW R IH N TH IY AH N Z
first-corinthians(2)	F ER S T K OW R IH N TH IY AH N Z
first-john	F ER S T JH AA N
first-john(2)	F ER S T JH AA N
first-kings	F ER S T K IH NG Z
first-kings(2)	F ER S T K IH NG Z
first-peter	F ER S T P IY T ER
first-peter(2)	F ER S T P IY T ER
first-samuel	F ER S T S AE M Y UW L
first-samuel(2)	F ER S T S AE M Y UW L
first-thessalonians	F ER S T TH EH S AH L OW N IY AH N Z
first-thessalonians(2)	F ER S T TH EH S AH L OW N IY AH N Z
first-timothy	F ER S T T IH M AH TH IY
first-timothy(2)	F ER S T T IH M AH TH IY
galatians	G AH L EY T IY AH N Z
genesis	JH EH N AH S AH S
habakkuk	HH AH B AE K AH K
haggai	HH AE G EY
hebrews	HH IY B R UW Z
hosea	HH OW S IY AH
hosea(2)	HH OW Z EY AH
isaiah	AY Z EY AH
isaiah(2)	AY Z AY AH
james	JH EY M Z
jeremiah	JH EH R AH M AY AH
job	JH AA B
job(2)	JH OW B
joel	JH OW AH L
john	JH AA N
jonah	JH OW N AH
joshua	JH AA SH UW AH
jude	JH UW D
judges	JH AH JH IH Z
lamentations	L AE M AH N T EY SH AH N Z
leviticus	L AH V IH T AH K AH S
luke	L UW K
malachi	M AH L AE CH IY
mark	M AA R K
matthew	M AE TH Y UW
micah	M AY K AH
nahum	N AE HH AH M
nehemiah	N IY AH M AY AH
numbers	N AH M B ER Z
obadiah	OW B AH D AY AH
philemon	F AH L EY M AH N
philippians	F AH L IH P IY AH N Z
proverbs	P R AA V ER B Z
revelation	R EH V AH L EY SH AH N
romans	R OW M AH N Z
ruth	R UW TH
sam	S AE M
second-chronicles	S EH K AH N D K R AA N IH K AH L Z
second-chronicles(2)	S EH K AH N K R AA N IH K AH L Z
second-corinthians	S EH K AH N D K OW R IH N TH IY AH N Z
second-corinthians(2)	S EH K AH N K OW R IH N TH IY AH N Z
second-john	S EH K AH N D JH AA N
second-john(2)	S EH K AH N JH AA N
second-kings	S EH K AH N D K IH NG Z
second-kings(2)	S EH K AH N K IH NG Z
second-peter	S EH K AH N D P IY T ER
second-peter(2)	S EH K AH N P IY T ER
second-samuel	S EH K AH N D S AE M Y UW L
second-samuel(2)	S EH K AH N S AE M Y UW L
second-thessalonians	S EH K AH N D TH EH S AH L OW N IY AH N Z
second-thessalonians(2)	S EH K AH N TH EH S AH L OW N IY AH N Z
second-timothy	S EH K AH N D T IH M AH TH IY
second-timothy(2)	S EH K AH N T IH M AH TH IY
songs-of-solomon	S AO NG Z AH V S AA L AH M AH N
songs-of-solomon(2)	S AO NG S AH V S AA L AH M AH N
songs-of-solomon(3)	S AO NG AH V S AA L AH M AH N
third-john	TH ER JH AA N
third-john(2)	TH ER D JH AA N
titus	T AY T AH S
zechariah	Z AH CH AE R AY AH
zephaniah	Z AH F EY N AY AH
